# These are not used but may need to be defined.
mild_winter = {}
severe_winter = {}
arctic = {}
arid = {}
tropical = {}

normal_winter = {
	# Kaga, Hida, Etchu, northern Shinano, Echigo, Dewa, Hokkaido, western and northern Mutsu
	379 380 381 382 383 384 385 386 392 393 394 442 443 444 445 446 540 541 553 554 555 556 557 558
	559 560 561 562 563 564 565 566 567 568 569 571 572 573 574 575 582 586 587 596 597 600 601
	602 603 604 605 607 608 609 610 611 612 613 614 615 616 630 642 644 645 646 647 650 651 652 653
	654 552 672 673 674 675 658 659 660 661 662 663 665 570 598 706 707 708
}

impassable = {
	686 687 688 689 690 691 692 693 694 707
	1072 1779 1780 1781 1782 1783 1784 1785
	1786 1787 1788 1789 1790 1791 1793 1794
	1795 1796 1797 1798 1799 1800 1801 1802
	1803 1804 1805 1806 1807 1808 1809 1810
	1811 1812 1813 1814 1950
}
